NO ./textures/space1.xpm
SO ./textures/space1.xpm

WE ./textures/space1.xpm


EA ./textures/space1.xpm

F   149,146,139
C   149,146,139







11111111111111111111111111111111111111
1E011111111111111110111111111111111111
10011111111111111110111111111111111111
10011111111111111110111111111111111111
10011111111111111110111111111111111111
10011111111111111110111111111111111111
10011111111111111110111111111111111111
10011111111111111110111111111111111111
10011111111111111110111111111111111111
11111111111111111111111111111111111111